23
21
000000000000000000000
011111111111111111110
010000000101000000010
011111110101011111110
010100011111110001010
010100010000010001010
011111111101111111110
000010000101000010000
000010111111111010000
000010100010001010000
000010101111101010000
211111101111101111113
000010101111101010000
000010101111101010000
000010100000001010000
011111111111111111110
010010001000100010010
011011111101111110110
001010100101001010100
011110110111011011110
010000010101010000010
011111111111111111110
000000000000000000000
